1,1,1,1,1,1,1,1,1,1,1,1,1,1,1
1,0,3,0,0,3,3,0,0,0,0,0,0,0,1
1,0,2,3,2,0,2,0,2,0,2,3,2,0,1
1,0,0,3,2,2,2,2,2,2,2,0,3,0,1
1,3,2,0,2,0,0,2,3,3,2,0,2,0,1
1,0,0,3,2,0,2,3,2,3,2,3,3,0,1
1,3,2,3,2,3,0,0,3,0,2,0,2,0,1
1,0,0,3,2,3,2,3,2,0,2,0,3,3,1
1,3,2,0,2,3,3,0,0,0,2,3,2,3,1
1,0,3,0,2,2,2,3,2,2,2,0,3,3,1
1,2,2,3,0,3,0,3,0,3,0,3,2,2,1
1,2,2,0,0,2,0,2,0,2,0,0,2,2,1
1,2,2,0,2,0,0,2,0,0,2,0,2,2,1
1,2,2,3,0,3,3,3,3,0,3,3,2,2,1
1,1,1,1,1,1,1,1,1,1,1,1,1,1,1
12
2,5
3,9
4,1
6,12
7,2
7,6
7,8
8,8
8,11
9,2
10,10
13,6
5
1,3,2
2,3,3
3,7,13
2,11,2
3,9,4
8,4
1,1,45,45
13,1,585,45