1,1,1,1,1,1,1,1,1,1,1,1,1,1,1
1,0,0,3,0,0,0,2,2,2,2,2,0,3,1
1,0,3,3,0,3,0,2,2,2,2,2,0,0,1
1,0,2,0,2,0,2,2,2,2,2,2,2,0,1
1,3,2,0,0,0,0,3,3,0,0,0,2,0,1
1,0,2,3,2,3,2,0,2,0,2,3,2,0,1
1,0,0,0,3,0,0,3,0,0,0,0,3,3,1
1,3,2,0,2,0,0,2,0,2,3,0,2,0,1
1,0,2,3,2,0,0,2,2,2,3,0,2,0,1
1,3,0,3,2,3,0,2,0,2,0,0,2,0,1
1,3,2,0,0,0,2,0,0,0,2,3,0,3,1
1,3,2,3,3,0,0,0,3,0,3,0,3,3,1
1,0,2,3,2,0,2,0,3,0,2,0,2,3,1
1,0,0,3,0,0,3,3,3,3,3,0,0,0,1
1,1,1,1,1,1,1,1,1,1,1,1,1,1,1
9
3,4
4,10
5,1
6,7
7,11
9,6
11,12
13,5
13,8
5
1,3,1
2,5,11
3,7,4
2,11,5
3,9,13
13,1
1,1,45,45
12,1,585,45