1,1,1,1,1,1,1,1,1,1,1,1,1,1,1
1,0,0,3,0,0,0,0,0,0,0,3,0,0,1
1,0,0,0,0,0,3,3,3,0,0,3,0,0,1
1,3,3,0,3,0,0,0,0,3,0,0,0,0,1
1,0,0,3,2,2,2,3,2,2,2,0,3,3,1
1,0,0,3,2,0,0,0,0,0,2,0,0,0,1
1,0,3,3,2,0,2,0,2,0,2,0,0,0,1
1,0,0,0,2,0,0,3,0,0,2,0,3,0,1
1,2,2,3,2,0,2,0,2,0,2,3,2,2,1
1,2,0,3,0,3,0,3,0,3,0,3,0,2,1
1,2,0,0,0,0,2,0,2,0,0,0,0,2,1
1,2,2,2,2,3,2,0,2,3,2,2,2,2,1
1,2,0,2,0,0,3,2,3,0,0,2,0,2,1
1,2,3,3,0,0,3,3,3,0,0,3,3,2,1
1,1,1,1,1,1,1,1,1,1,1,1,1,1,1
12
1,5
6,1
6,3
10,2
11,5
7,5
3,10
10,10
4,13
10,13
2,7
13,7
5
1,3,1
2,3,9
3,7,1
2,8,1
3,9,3
7,13
1,1,45,45
13,1,585,45