1,1,1,1,1,1,1,1,1,1,1,1,1,1,1
1,0,0,3,0,0,0,0,0,0,3,0,0,0,1
1,0,0,3,0,0,3,3,3,3,0,3,0,3,1
1,0,0,0,2,2,2,2,2,2,2,0,0,0,1
1,0,3,3,2,0,3,3,3,0,2,3,3,0,1
1,3,3,3,2,0,3,3,3,0,2,3,3,3,1
1,0,0,0,2,0,0,0,0,0,2,0,0,0,1
1,0,3,0,2,0,0,0,0,0,2,0,0,0,1
1,0,0,0,2,0,2,2,2,0,2,3,0,3,1
1,3,3,0,2,0,2,2,2,0,2,0,3,0,1
1,3,0,3,2,3,2,3,2,3,2,0,3,0,1
1,0,0,0,0,0,0,0,0,0,0,0,0,0,1
1,0,2,2,2,3,2,0,2,3,2,2,2,0,1
1,3,0,3,0,3,0,0,0,3,0,3,0,3,1
1,1,1,1,1,1,1,1,1,1,1,1,1,1,1
12
1,11
2,8
5,2
6,7
7,1
7,6
7,12
9,7
10,2
12,3
12,7
12,11
5
1,3,2
2,3,10
3,9,2
2,11,5
3,6,2
7,4
1,1,45,45
13,1,585,45