1,1,1,1,1,1,1,1,1,1,1,1,1,1,1
1,0,2,2,2,3,3,0,0,3,3,0,0,0,1
1,3,2,2,2,3,2,0,2,3,2,3,2,0,1
1,0,2,2,2,0,0,3,0,0,0,3,3,3,1
1,0,2,2,2,0,2,3,2,3,2,0,2,0,1
1,3,2,2,2,0,0,0,3,0,0,0,3,3,1
1,0,2,2,2,0,2,3,2,0,2,0,2,3,1
1,0,0,0,0,0,3,0,3,3,0,3,0,0,1
1,0,2,2,2,0,2,0,2,0,2,0,2,3,1
1,3,3,3,2,0,3,3,0,3,3,3,0,0,1
1,3,3,3,2,0,2,0,2,0,2,3,2,0,1
1,0,2,2,2,0,3,3,0,3,0,0,3,0,1
1,3,2,2,2,3,2,3,2,0,2,3,2,0,1
1,3,2,2,2,3,0,3,3,0,3,3,3,0,1
1,1,1,1,1,1,1,1,1,1,1,1,1,1,1
6
1,11
2,7
5,5
5,9
9,5
9,13
3
1,1,2
2,10,9
3,13,5
1,13
13,1,585,45