1,1,1,1,1,1,1,1,1,1,1,1,1,1,1
1,0,0,0,0,0,2,0,0,0,0,0,0,0,1
1,2,0,2,0,2,2,0,0,3,3,0,0,0,1
1,0,3,0,3,0,2,0,3,0,2,3,3,0,1
1,2,3,2,0,2,2,0,3,0,0,0,3,0,1
1,0,0,3,0,0,2,0,0,3,3,0,0,3,1
1,2,3,2,0,2,2,2,2,2,2,2,3,1,1
1,0,0,0,3,3,0,3,3,3,0,3,0,0,1
1,2,2,2,2,2,2,0,2,0,2,0,2,0,1
1,0,0,0,0,0,2,0,0,0,0,0,0,3,1
1,0,2,3,3,0,2,0,2,3,2,3,2,0,1
1,0,2,0,0,3,2,0,0,3,0,3,0,0,1
1,0,2,2,3,0,3,0,2,0,2,0,2,0,1
1,3,0,2,0,0,2,0,3,0,0,0,3,0,1
1,1,1,1,1,1,1,1,1,1,1,1,1,1,1
11
1,3
1,9
4,5
4,11
4,13
7,2
7,11
9,3
11,5
12,11
13,2
5
1,3,5
2,3,10
3,7,7
2,8,7
3,9,2
1,13
1,1,45,45
13,1,585,45