1,1,1,1,1,1,1,1,1,1,1,1,1,1,1
1,0,0,3,0,0,0,0,0,0,0,3,0,0,1
1,0,0,3,0,0,0,0,0,3,0,0,3,0,1
1,0,2,0,2,0,2,0,2,0,2,0,3,3,1
1,0,3,3,0,3,0,3,0,3,0,3,0,3,1
1,3,2,0,2,0,2,0,2,0,2,0,2,0,1
1,0,3,3,0,3,3,0,0,3,0,0,0,3,1
1,0,2,0,2,2,2,0,2,2,2,0,2,3,1
1,0,0,0,2,0,0,3,0,0,2,0,0,0,1
1,2,0,2,2,3,2,0,2,0,2,2,2,2,1
1,0,0,0,2,3,0,3,0,3,2,0,0,3,1
1,0,2,3,2,0,2,0,2,3,2,0,2,0,1
1,0,3,0,2,3,3,3,0,3,2,3,0,0,1
1,3,0,3,3,0,0,3,0,3,0,0,3,0,1
1,1,1,1,1,1,1,1,1,1,1,1,1,1,1
10
1,4
2,9
4,1
6,10
7,2
7,6
11,3
11,8
11,10
12,12
5
1,3,1
2,5,12
3,7,8
2,11,1
3,9,2
13,10
1,1,45,45
14,1,585,45