1,1,1,1,1,1,1,1,1,1,1,1,1,1,1
1,0,0,3,0,0,3,2,3,3,3,3,3,0,1
1,0,2,0,0,0,3,0,3,0,0,0,2,3,1
1,0,0,2,0,2,0,3,0,2,2,2,3,2,1
1,2,3,0,0,3,0,2,0,0,0,0,0,0,1
1,2,0,2,0,2,2,0,0,2,3,0,0,0,1
1,2,0,0,3,0,0,2,0,2,0,2,0,2,1
1,2,0,2,0,2,2,2,2,2,3,2,0,2,1
1,2,3,0,3,0,2,3,3,0,0,0,3,2,1
1,2,0,2,0,2,3,3,2,2,0,2,0,2,1
1,2,0,0,0,2,3,3,2,0,3,0,0,2,1
1,0,3,2,0,2,2,2,2,2,0,2,0,2,1
1,0,0,3,3,0,0,0,0,0,2,0,3,0,1
1,0,2,3,0,0,0,0,0,3,0,0,0,3,1
1,1,1,1,1,1,1,1,1,1,1,1,1,1,1
10
4,2
8,5
12,5
3,10
6,13
13,6
10,9
6,8
12,11
13,1
3
1,13,13
2,4,8
3,3,13
6,9
1,1,45,45