1,1,1,1,1,1,1,1,1,1,1,1,1,1,1
1,0,0,3,0,0,2,2,2,0,0,0,0,0,1
1,0,2,0,2,0,2,2,2,0,2,3,2,0,1
1,3,3,3,0,0,0,3,3,0,0,0,0,0,1
1,0,2,0,2,0,0,3,0,0,2,3,2,3,1
1,0,0,3,0,3,3,3,0,0,0,0,0,3,1
1,3,2,0,2,0,0,3,3,0,2,3,2,3,1
1,3,0,0,0,0,2,2,2,0,0,0,0,0,1
1,0,2,0,2,3,2,2,2,0,2,0,2,3,1
1,3,0,0,0,0,0,0,0,0,3,3,0,0,1
1,0,2,3,2,0,2,2,2,0,2,0,2,0,1
1,3,0,0,0,0,2,2,2,0,0,0,0,0,1
1,0,2,0,2,0,2,2,2,0,2,3,2,0,1
1,0,0,3,0,0,2,2,2,0,0,0,0,3,1
1,1,1,1,1,1,1,1,1,1,1,1,1,1,1
7
5,3
3,7
2,9
5,11
9,7
12,1
11,5
3
1,11,12
2,7,4
3,3,13
13,5
1,1,45,45