1,1,1,1,1,1,1,1,1,1,1,1,1,1,1
1,2,2,2,2,0,2,2,0,0,0,0,3,3,1
1,2,2,2,3,2,2,2,0,3,0,3,3,3,1
1,2,2,2,3,2,2,2,0,0,3,2,3,3,1
1,2,2,2,3,2,2,2,0,2,2,3,2,3,1
1,0,0,3,0,0,0,0,3,0,3,0,3,3,1
1,3,0,0,3,2,2,2,0,2,0,2,0,3,1
1,3,2,0,3,2,0,2,0,0,3,3,3,0,1
1,0,3,0,3,2,2,2,3,2,3,2,3,0,1
1,0,2,3,0,0,3,0,0,0,3,0,0,0,1
1,0,0,3,3,0,2,0,0,0,3,0,2,3,1
1,2,2,2,3,2,2,2,0,3,2,3,0,3,1
1,2,2,2,3,2,2,2,0,0,2,0,2,3,1
1,2,2,0,2,0,0,2,3,3,0,0,3,3,1
1,1,1,1,1,1,1,1,1,1,1,1,1,1,1
9
3,8
8,10
8,2
13,8
11,13
5,1
3,13
10,1
7,6
3
1,4,2
2,4,12
3,11,7
13,1
1,5,45,225