1,1,1,1,1,1,1,1,1,1,1,1,1,1,1
1,2,2,2,0,0,3,3,0,0,3,3,0,0,1
1,2,2,2,0,3,2,3,2,3,2,0,2,0,1
1,2,2,2,0,3,0,0,3,3,0,0,3,0,1
1,0,0,0,2,3,2,0,2,3,0,0,3,0,1
1,0,3,0,0,3,3,3,0,3,3,3,2,3,1
1,0,2,0,2,0,2,0,2,2,2,2,2,2,1
1,3,0,3,3,0,3,3,0,2,2,2,2,2,1
1,0,2,0,2,0,2,3,2,2,2,2,2,2,1
1,3,3,3,0,0,0,0,0,2,2,2,2,2,1
1,3,2,0,2,0,2,0,2,3,3,3,3,2,1
1,3,0,0,0,3,3,0,3,3,3,0,0,0,1
1,0,2,3,2,0,2,0,2,3,2,0,2,3,1
1,0,0,3,0,3,0,3,3,3,3,0,0,3,1
1,1,1,1,1,1,1,1,1,1,1,1,1,1,1
5
1,5
3,11
6,3
13,4
12,13
3
1,1,10
2,9,11
3,12,3
12,10
1,4,45,180