1,1,1,1,1,1,1,1,1,1,1,1,1,1,1
1,0,0,3,0,0,0,0,0,0,2,2,2,2,1
1,0,3,3,3,3,0,3,0,3,3,2,2,2,1
1,0,2,0,2,0,2,3,2,0,2,2,2,2,1
1,3,3,0,0,3,0,3,3,3,0,0,0,0,1
1,3,2,0,2,3,2,0,2,0,2,3,2,0,1
1,3,0,0,0,3,3,0,0,0,0,2,0,0,1
1,3,3,3,2,2,3,0,3,3,0,3,0,3,1
1,3,2,0,2,2,3,2,0,0,2,0,2,0,1
1,3,3,3,0,0,3,3,3,0,0,3,0,0,1
1,3,2,3,2,2,0,2,0,0,2,3,2,3,1
1,2,0,0,3,0,3,0,0,3,0,3,3,0,1
1,3,3,2,0,2,0,2,3,3,2,0,2,0,1
1,3,0,3,0,0,3,0,0,3,0,3,0,0,1
1,1,1,1,1,1,1,1,1,1,1,1,1,1,1
4
8,1
11,4
5,13
3,6
3
1,11,13
2,8,7
3,5,2
1,13
1,1,45,45